Deleting	delete
Starting	part
ask	ask
block	block
current	current
data	data
delete	delete
exception	exception
file	file
part	part
rand	rand
replicate	replicate
root	root
s	s
serving	serving
size	size
thread	thread
transfer	transfer
user	user
while	while
